31 31 31 0 32 0 32 0 33 33 33 0 4 4 4 4 4 4 
0 31 0 0 32 0 32 0 33 0 0 0 0 32 32 32 32 0  
0 31 0 0 32 32 32 0 33 33 0 0 0 0 33 33 0 0  
0 31 0 0 32 0 32 0 33 0 0 0 0 0 0 0 0 0
37 31 37 37 32 37 32 37 33 33 33 37 37 37 37 37 37 37
0 0 0 0 0 0 0 0 0 0 0 0 0 0 0 0 0 0 
0 0 0 0 0 0 0 34 34 34 0 35 35 0 0 36 36 0 
0 0 0 0 0 0 0 34 0 0 0 35 0 35 0 36 0 36 
0 0 36 36 0 0 0 34 34 0 0 35 0 35 0 36 0 36  
0 35 35 35 35 0 0 34 0 0 0 35 0 35 0 36 0 36 
34 34 34 34 34 34 37 34 34 34 37 35 37 35 37 36 36 37 
